4 9 3 7 6 5 0 2 2 6 0 1 4 9 2 9 1 0 1 1 5 1 7 1 7 7 6 3 5 9 4 4 6 0 2 0 2 3 2 4 9 3 0 2 8 0 4 0 1 8 6 7 7 2 3 9 1 0 2 8 8 0 9 7 8 6 6 6 0 5 6 5 1 1 8
3 2 6 0 4 3 6 8 8 5 0 8 8 1 7 1 5 7 2 3 8 6 6 9 8 4 2 2 4 2 2 0 1 0 2 4 9 5 0 5 5 1 8 8 1 6 9 4 8 0 3 2 2 1 0 2 5 1 5 4 2 6 4 9 4 6 3 9 8 1 2 8 7
3 6 7 7 6 5 8 9 2 7 6 8 8 1 6 3 5 9 8 3 1 2 4 7 7 8 8 6 5 2 0 1 4 1 1 7 4 1 1 0 9 1 3 6 0 1 1 6 4 9 5 0 7 6 6 2 9 0 7 7 9 4 3 6 4 6 0 5 8 5 1 9 4
1 9 8 5 6 0 1 6 2 6 4 7 9 0 7 6 1 5 3 2 1 0 3 8 7 2 7 5 5 7 1 2 6 9 2 5 1 8 2 7 5 6 8 7 9 8 9 3 0 2 7 6 1 7 6 1 1 4 6 1 6 2 5 4 9 3 5 6 4 9 5 9 0
3 7 9 8 0 4 5 8 3 8 1 8 2 3 2 3 3 6 8 6 1 2 0 1 6 2 4 3 7 3 6 5 6 9 8 4 6 7 0 3 7 8 5 8 5 3 3 0 5 2 7 5 8 3 3 3 3 7 9 3 9 0 7 5 2 1 6 6 0 6 9 2 3 8