0 5 3 3 6 9 8 8 7 9 5 6 5 1 3 7 2 8 5 5 9 3 8 8 3 4 9 9 8 9 4 7 0 7 4 1 6 1 8 1 5 5 0 1 2 5 3 9 7 0 6 4 6 4 8 1 7 1 9 4 6 7 0 8 3 4 8 1 9 7 2 1 4 4 8
8 8 9 8 7 9 0 6 7 6 5 0 3 7 9 5 9 0 3 6 6 9 6 7 2 4 9 4 9 9 2 5 4 5 2 7 9 0 3 3 7 2 9 6 3 6 1 6 2 6 5 8 9 7 6 0 3 9 4 9 8 5 7 6 7 4 1 3 9 7 3 5 9 4 4
1 0 2 3 7 4 4 3 2 9 7 0 9 3 5 5 4 7 7 9 8 2 6 2 9 6 1 4 5 9 1 4 4 2 9 3 6 4 5 1 4 2 8 6 1 7 1 5 8 5 8 7 3 3 9 7 4 6 7 9 1 8 9 7 5 7 1 2 1 1 9 5 6 1 8
7 3 8 5 7 8 3 6 4 4 7 5 8 4 4 8 4 2 3 5 5 5 5 8 1 0 5 0 0 2 5 6 1 1 4 9 2 3 9 1 5 1 8 8 9 3 0 9 9 4 6 3 4 2 8 4 1 3 9 3 6 0 8 0 3 8 3 0 9 1 6 6 2 8 1
8 8 1 1 5 0 3 7 1 5 2 8 4 9 6 7 0 5 9 7 4 1 6 2 5 6 2 8 2 3 6 0 9 2 1 6 8 0 7 5 1 5 0 1 7 7 7 2 5 3 8 7 4 0 2 5 6 4 2 5 3 4 7 0 8 7 9 0 8 9 1 3 7 2 9