1 7 2 2 8 2 8 6 1 1 5 1 5 9 1 5 6 8 3 7 2 5 2 4 1 6 3 0 7 7 2 2 5 4 4 0 6 3 3 7 8 7 5 9 3 1 0 5 9 8 2 6 7 6 0 9 4 4 2 0 3 2 6 1 9 2 4 2 8 5 3 1 7 0 1
8 7 8 1 7 7 2 9 6 0 2 3 5 4 1 3 0 6 0 6 7 2 1 3 6 0 4 6 0 0 0 3 8 9 6 6 1 0 9 3 6 4 7 0 9 5 1 4 1 4 1 7 1 8 5 7 7 7 0 1 4 1 8 0 6 0 6 4 4 3 6 3 6 8 1
5 4 6 4 4 4 0 0 5 3 3 1 6 0 8 7 7 8 3 1 4 3 1 7 4 4 4 0 8 1 1 9 4 9 4 2 2 9 7 5 5 9 9 3 1 4 0 1 1 8 8 8 6 8 3 3 1 4 8 3 2 8 0 2 7 0 6 5 5 3 8 3 3 0 0
4 6 9 3 2 9 0 1 1 5 7 4 4 1 4 7 5 6 3 1 3 9 9 9 7 2 2 1 7 0 3 8 0 4 6 1 7 0 9 2 8 9 4 5 7 9 0 9 6 2 7 1 6 6 2 2 6 0 7 4 0 7 1 8 7 4 9 9 7 5 3 5 9 2 1
2 7 5 6 0 8 4 4 1 4 7 3 7 8 2 3 3 0 3 2 7 0 3 3 0 1 6 8 2 3 7 1 9 3 6 4 8 0 0 2 1 7 3 2 8 5 7 3 4 9 3 5 9 4 7 5 6 4 3 3 4 1 2 9 9 4 3 0 2 4 8 5 0 2 3