4 5 7 3 2 2 1 4 5 9 7 8 4 3 2 8 2 6 4 1 4 2 1 6 8 4 8 7 8 7 2 1 6 7 3 3 6 7 0 1 0 6 1 5 0 9 4 2 4 3 4 5 6 9 8 4 4 0 1 8 7 3 3 1 2 8 1 0 1 0 7 9 4 5 1 2
7 2 2 3 7 3 7 8 8 6 1 2 6 0 5 8 1 6 5 6 6 8 0 5 3 7 1 4 3 9 6 1 2 7 8 8 8 7 3 2 5 2 7 3 7 3 8 9 0 3 9 2 8 9 0 5 0 6 8 6 5 3 2 4 1 3 8 0 6 2 7 9 6 0 2
5 9 3 0 3 8 7 7 2 7 6 9 7 7 8 3 7 9 2 8 6 8 4 0 9 3 2 5 3 6 5 8 8 0 7 3 3 9 8 8 4 5 7 2 1 8 7 4 6 0 2 1 0 5 3 1 1 4 8 3 3 5 1 3 2 3 8 5 0 4 7 8 2
7 1 6 9 3 7 6 2 1 8 0 4 9 0 4 7 9 5 5 9 7 9 5 9 2 9 0 5 9 1 6 5 5 4 7 0 5 0 5 7 7 7 5 1 4 3 0 8 1 7 5 1 1 2 6 9 8 9 8 5 1 8 8 4 0 8 7 1 8 5 6 4 0 2
6 0 3 5 3 0 5 5 8 3 7 3 7 8 3 2 4 2 2 9 2 4 1 8 5 6 2 5 6 4 4 2 5 5 0 2 2 6 7 2 1 5 5 9 8 0 2 7 4 0 1 2 6 1 7 9 7 1 9 2 8 0 4 7 1 3 9 6 0 6 8 9 1 6