3 8 2 8 6 6 5 2 7 7 0 0 9 7 5 2 7 6 7 0 6 9 7 7 7 0 3 6 4 3 9 2 6 0 2 2 4 3 7 2 8 4 1 8 4 0 8 8 3 2 5 1 8 4 8 7 7 0 4 7 2 6 3 8 4 4 0 3 7 9 5 3 0 1 6
6 9 0 5 4 6 5 9 3 7 4 6 1 6 1 9 3 2 3 8 4 0 3 6 3 8 9 3 1 3 1 3 6 4 3 2 7 1 3 7 6 8 8 8 4 1 0 2 6 8 1 1 2 1 9 8 9 1 2 7 5 2 2 3 0 5 6 2 5 6 7 5 6 2 5
4 7 0 1 7 2 5 0 8 6 3 4 9 7 6 5 3 6 7 2 8 8 6 0 5 9 6 6 7 5 2 7 4 0 8 6 8 6 2 7 4 0 7 9 1 2 8 5 6 5 7 6 9 9 6 3 1 3 7 8 9 7 5 3 0 3 4 6 6 0 6 1 6 6 6
9 8 0 4 2 1 8 2 6 7 7 2 4 5 6 0 5 3 0 6 6 0 7 7 3 8 9 9 6 2 4 2 1 8 3 4 0 8 5 9 8 8 2 0 7 1 8 6 4 6 8 2 6 2 3 2 1 5 0 8 0 2 8 8 2 8 6 3 5 9 7 4 6 8 3
9 6 5 4 3 5 8 8 5 6 6 8 5 5 0 3 7 7 3 1 3 1 2 9 6 5 8 7 9 7 5 8 1 0 5 0 1 2 1 4 9 1 6 2 0 7 6 5 6 7 6 9 9 5 0 6 5 9 7 1 5 3 4 4 7 6 3 4 7 0 3 2 0 8 5