3 2 1 5 6 0 3 6 7 4 8 2 8 6 0 8 3 7 8 6 5 6 8 0 3 0 7 3 0 6 2 6 5 7 6 3 3 4 6 9 7 7 4 2 9 5 6 3 4 6 4 3 7 1 6 7 0 9 3 9 7 1 9 3 0 6 0 8 7 6 9 6 3 4 9
5 3 2 8 8 4 6 8 3 3 6 1 3 0 3 8 8 2 9 4 3 1 0 4 0 8 0 0 2 9 6 8 7 3 8 6 9 1 1 7 0 6 6 6 6 6 1 4 6 8 0 0 0 1 5 1 2 1 1 4 3 4 4 2 2 5 6 0 2 3 8 7 4 4 7
4 3 2 5 2 5 0 7 6 9 3 8 7 0 7 7 7 7 5 1 9 3 2 9 9 9 4 2 1 3 7 2 7 7 2 1 1 2 5 8 8 4 3 6 0 8 7 1 5 8 3 4 8 3 5 6 2 6 9 6 1 6 6 1 9 8 0 5 7 2 5 2 6 6 1
2 2 0 6 7 9 7 5 4 0 6 2 1 0 6 2 0 8 0 6 4 9 8 8 2 9 1 8 4 5 4 3 9 5 3 0 1 5 2 9 9 8 2 0 9 2 5 0 3 0 0 5 4 9 8 2 5 7 0 4 3 3 9 0 5 5 3 5 7 0 1 6 8 6 5
3 1 2 0 5 2 6 4 9 5 6 1 4 8 5 7 2 4 9 2 5 7 3 8 6 2 0 6 9 1 7 4 0 3 6 9 5 2 1 3 5 3 3 7 3 2 5 3 1 6 6 6 3 4 5 4 6 6 5 8 8 5 9 7 2 8 6 6 5 9 4 5 1 1 3