6 4 4 1 3 7 0 3 3 1 3 9 3 6 7 2 1 1 8 5 6 9 5 5 3 9 5 2 1 0 8 4 5 8 4 0 7 2 4 4 3 2 3 8 3 5 5 8 6 0 6 3 1 0 6 8 0 6 9 6 4 9 2 4 8 5 1 2 3 2 6 3 2 6 9
9 5 1 4 6 0 3 5 9 6 0 3 7 2 9 7 2 5 3 1 9 8 3 6 8 4 2 3 3 6 3 9 0 4 6 3 2 1 3 6 7 1 0 1 1 6 1 9 2 8 2 1 7 1 1 1 5 0 2 8 2 8 0 1 6 0 4 4 8 8 0 5 8 8 0
2 3 8 2 0 3 1 9 8 1 4 9 3 0 9 6 3 6 9 5 9 6 7 3 5 8 3 2 7 4 2 0 2 4 9 8 8 2 4 5 6 8 4 9 4 1 2 7 3 8 6 0 5 6 6 4 9 1 3 5 2 5 2 6 7 0 6 0 4 6 2 3 4 4 5
0 5 4 9 2 2 7 5 8 1 1 5 1 7 0 9 3 1 4 9 2 1 8 7 9 5 9 2 7 1 8 0 0 1 9 4 0 9 6 8 8 6 6 9 8 6 8 3 7 0 3 7 3 0 2 2 0 0 4 7 5 3 1 4 3 3 8 1 8 1 0 9 2 7 0
8 0 3 0 0 1 7 2 0 5 9 3 5 5 3 0 5 2 0 7 0 0 7 0 6 0 7 2 2 3 3 9 9 9 4 6 3 9 9 0 5 7 1 3 1 1 5 8 7 0 9 9 6 3 5 7 7 7 3 5 9 0 2 7 1 9 6 2 8 5 0 6 1 1 4