6 5 1 4 8 3 7 5 2 6 2 0 9 5 6 5 3 4 6 7 1 3 2 9 0 0 2 5 9 9 4 3 9 7 6 6 3 1 1 4 5 4 5 9 0 2 6 8 5 8 9 8 9 7 9 1 1 5 8 3 7 0 9 3 4 1 9 3 7 0 4 4 1 1 5
5 1 2 1 9 2 0 1 1 7 1 6 4 8 8 0 5 6 6 9 4 5 9 3 8 1 3 1 1 8 3 8 4 3 7 6 5 6 2 0 6 2 7 8 4 6 3 1 0 4 9 0 3 4 6 2 9 3 9 5 0 0 2 9 4 5 8 3 4 1 1 6 4 8 2
4 1 1 4 9 6 9 7 5 8 3 2 6 0 1 1 8 0 0 7 3 1 6 9 9 4 3 7 3 9 3 5 0 6 9 6 6 2 9 5 7 1 2 4 1 0 2 7 3 2 3 9 1 3 8 7 4 1 7 5 4 9 2 3 0 7 1 8 6 2 4 5 4 5 4
3 2 2 2 0 3 9 5 5 2 7 3 5 2 9 5 2 4 0 2 4 5 9 0 3 8 0 5 7 4 4 5 0 2 8 9 2 2 4 6 8 8 6 2 8 5 3 3 6 5 4 2 2 1 3 8 1 5 7 2 2 1 3 1 1 6 3 2 8 8 1 1 2 0 5
2 1 4 6 4 8 9 8 0 5 1 8 0 0 9 2 0 2 4 7 1 9 3 9 1 7 1 0 5 5 5 3 9 0 1 1 3 9 4 3 3 1 6 6 8 1 5 1 5 8 2 8 8 4 3 6 8 7 6 0 6 9 6 1 1 0 2 5 0 5 1 7 1 0 0