7 3 9 2 7 6 2 3 8 5 5 5 3 3 8 6 2 7 2 5 5 3 5 3 8 8 3 0 9 6 0 6 7 1 6 4 4 6 6 2 3 7 0 9 2 2 6 4 6 8 0 9 6 7 1 2 5 4 0 6 1 8 6 9 5 0 2 1 4 3 1 7 6 2 1
1 6 6 8 1 4 0 0 9 7 5 9 5 2 8 1 4 9 3 9 0 7 2 2 2 6 0 1 1 1 2 6 8 1 1 5 3 1 0 8 3 8 7 3 1 7 6 1 7 3 2 3 2 3 5 2 6 3 6 0 5 8 3 8 1 7 3 1 5 1 0 3 4 5 9
5 7 3 6 5 3 8 2 2 3 5 3 4 9 9 2 9 3 5 8 2 2 8 3 6 8 5 1 0 0 7 8 1 0 8 8 4 6 3 4 3 4 9 9 8 3 5 1 8 4 0 4 4 5 1 7 0 4 2 7 0 1 8 9 3 8 1 9 9 4 2 4 3 4 1
0 0 9 0 5 7 5 3 7 6 2 5 7 7 6 7 5 7 1 1 1 8 0 9 0 0 8 8 1 6 4 1 8 3 3 1 9 2 0 1 9 6 2 6 2 3 4 1 6 2 8 8 1 6 6 5 2 1 3 7 4 7 1 7 3 2 5 4 7 7 7 2 7 7 8
3 4 8 8 7 7 4 3 6 6 5 1 8 8 2 8 7 5 2 1 5 6 6 8 5 7 1 9 5 0 6 3 7 1 9 3 6 5 6 5 3 9 0 3 8 9 4 4 9 3 6 6 4 2 1 7 6 4 0 0 3 1 2 1 5 2 7 8 7 0 2 2 2 3 6