4 6 4 6 3 6 3 5 7 5 5 5 0 3 5 6 5 5 7 6 9 4 8 8 8 6 5 4 9 5 0 2 7 0 8 5 3 9 2 3 6 1 7 1 0 5 5 0 2 1 3 1 1 4 7 4 1 3 7 4 4 1 0 6 1 3 4 4 4 5 5 4 4 1 9
2 1 0 1 3 3 6 1 7 2 9 6 2 8 5 6 9 4 8 9 1 9 3 3 6 9 1 8 4 7 2 9 4 7 8 5 8 0 7 2 9 1 5 6 0 8 8 5 1 0 3 9 6 7 8 1 9 5 9 4 2 9 8 3 3 1 8 6 4 8 0 7 5
6 0 8 3 6 7 9 5 5 1 4 9 6 6 3 6 4 4 8 9 6 5 5 9 2 9 4 8 1 8 7 8 5 1 7 8 4 0 3 8 7 7 3 3 2 6 2 4 7 0 5 1 9 4 5 0 5 0 4 1 9 8 4 7 7 4 2 0 1 4 1 8 3 9 4
7 7 3 1 2 0 2 8 1 5 8 8 6 8 4 5 7 0 7 2 9 0 5 4 4 0 5 7 5 1 0 6 0 1 2 8 5 2 5 8 0 5 6 5 9 4 7 0 3 0 4 6 8 3 6 3 4 4 5 9 2 6 5 2 5 5 2 1 3 7 0 8 0 6
8 7 5 2 0 9 5 9 3 4 5 3 6 0 7 3 1 6 2 2 6 1 1 8 7 2 8 1 7 3 9 2 8 0 7 4 6 2 3 0 9 4 6 8 5 3 6 7 8 2 3 1 0 6 0 9 7 9 2 1 5 9 3 6 0 1 9 4 6 2 3