4 7 9 3 4 3 4 2 1 0 6 8 7 8 1 3 4 9 7 3 4 6 9 5 9 2 4 6 4 6 9 7 5 2 5 0 6 2 4 6 9 5 8 6 1 6 9 0 9 1 7 8 5 7 3 9 7 6 5 9 5 1 9 3 9 2 9 3 9 5 5 6
7 5 4 2 7 1 4 6 5 4 9 1 0 4 5 6 8 6 0 7 0 2 0 9 0 1 2 6 0 6 8 1 8 7 0 4 9 8 4 1 7 8 0 7 9 1 7 3 9 2 4 0 7 1 9 4 5 9 6 3 2 3 0 6 0 2 5 4 7 0 7 9 0
1 7 7 4 5 2 7 5 1 3 1 8 6 8 0 9 8 2 2 8 4 7 3 0 8 6 0 7 6 6 5 3 6 8 6 6 8 5 5 5 1 6 4 6 7 7 0 2 9 1 1 3 3 6 8 2 7 5 6 3 1 0 7 2 2 3 3 4 6 7 2 6 1 1
3 7 0 5 4 9 0 7 9 5 3 6 5 8 3 4 5 3 8 6 3 7 1 9 6 2 3 5 8 5 6 3 1 2 6 1 8 3 8 7 1 5 6 7 7 4 1 1 8 7 3 8 5 2 7 7 2 2 9 2 2 5 9 4 7 4 3 3 7 3 7 8 5 6 9
5 5 3 8 4 5 6 2 4 6 8 0 1 0 1 3 9 0 5 7 2 7 8 7 1 0 1 6 5 1 2 9 6 6 6 3 6 7 6 4 4 5 1 8 7 2 4 6 5 6 5 3 7 3 0 4 0 2 4 4 3 6 8 4 1 4 0 8 1 4 4 8 8 7 3
2 9 5 7 8 4 7 3 4 8 4 9 0 3 0 1 9 4 7 7 8 8 8 0 2 0 4 6 0 3 2 4 6 6 0 8 4 2 8 7 5 3 5 1 8 4 8 3 6 4 9 5 9 1 9 5 0 8 2 8 8 8 3 2 3 2 0 6 5 2 2 1 2
8 1 0 4 1 9 0 4 4 8 0 4 7 2 4 7 9 4 9 2 9 1 3 4 2 2 8 4 9 5 1 9 7 0 2 2 6 0 1 3 1 0 4 3 0 6 2 4 1 0 7 1 7 9 7 1 5 0 2 7 9 3 4 3 3 2 6 3 4 0 7 9
5 9 6 0 5 3 1 4 4 6 0 5 3 2 3 0 4 8 8 5 2 8 9 7 2 9 1 7 6 5 9 8 7 6 0 1 6 6 6 7 8 1 1 9 3 7 9 3 2 3 7 2 4 5 3 8 5 7 2 0 9 6 0 7 5 8 2 2 7 7 1 7 8 4 8
3 3 6 1 6 1 3 5 8 2 6 1 2 8 9 6 2 2 6 1 1 8 1 2 9 4 5 5 9 2 7 4 6 2 7 6 7 1 3 7 7 9 4 4 8 7 5 8 6 7 5 3 6 5 7 5 4 4 8 6 1 4 0 7 6 1 1 9 3 1 1 2 5 9 5
8 5 1 2 6 5 5 7 5 9 7 3 4 5 7 3 0 1 5 3 3 3 6 4 2 6 3 0 7 6 7 9 8 5 4 4 3 3 8 5 7 6 1 7 1 5 3 3 3 4 6 2 3 2 5 2 7 0 5 7 2 0 5 3 0 3 9 8 8 2 8 9 4 9