9 0 3 4 2 5 9 5 6 6 2 3 2 9 7 5 7 8 2 4 8 8 7 3 5 0 2 9 2 5 9 1 6 6 8 2 5 8 9 4 4 5 6 8 9 4 6 5 5 9 9 2 6 5 8 4 5 4 7 6 2 6 9 4 5 2 8 7 8 0 5 1 6 5 0
1 7 2 0 6 7 4 7 8 5 4 1 7 8 8 7 9 8 2 2 7 6 8 0 6 5 3 6 6 5 0 6 4 1 9 1 0 9 7 3 4 3 4 5 2 8 8 7 8 3 3 8 6 2 1 7 2 6 1 5 6 2 6 9 5 8 2 6 5 4 4 7 8 2 0
5 6 7 2 9 8 7 7 5 6 4 2 6 3 2 5 3 2 1 5 9 4 2 9 4 4 1 8 0 3 9 9 4 3 2 1 7 0 0 0 0 9 0 5 4 2 6 5 0 7 6 3 0 9 5 5 8 8 4 6 5 8 9 5 1 7 1 7 0 9 1 4 7 6 0
7 4 3 7 1 3 6 8 9 3 3 1 9 4 6 9 0 9 0 9 8 1 9 0 4 5 0 1 2 9 0 3 0 7 0 9 9 5 6 6 2 2 6 6 2 0 3 0 3 1 8 2 6 4 9 3 6 5 7 3 3 6 9 8 4 1 9 5 5 5 7 7 6 9 6
3 7 8 7 6 2 4 9 1 8 8 5 2 8 6 5 6 8 6 6 0 7 6 0 0 5 6 6 0 2 5 6 0 5 4 4 5 7 1 1 3 3 7 2 8 6 8 4 0 2 0 5 5 7 4 4 1 6 0 3 0 8 3 7 0 5 2 3 1 2 2 4 2 5 8
7 2 2 3 4 3 8 8 5 4 1 2 3 1 7 9 4 8 1 3 8 8 5 5 0 0 7 5 6 8 9 3 8 1 1 2 4 9 3 5 3 8 6 3 1 8 6 3 5 2 8 7 0 8 3 7 9 9 8 4 5 6 9 2 6 1 9 9 8 1 7 9 4 5 2
3 3 6 4 0 8 7 4 2 9 5 9 1 1 8 0 7 4 7 4 5 3 4 1 9 5 5 1 4 2 0 3 5 1 7 2 6 1 8 4 2 0 0 8 4 5 5 0 9 1 7 0 8 4 5 6 8 2 3 6 8 2 0 0 8 9 7 7 3 9 4 5 5 8 4
2 6 7 9 2 1 4 2 7 3 4 7 7 5 6 0 8 7 9 6 4 4 2 7 9 2 0 2 7 0 8 3 1 2 1 5 0 1 5 6 4 0 6 3 4 1 3 4 1 6 1 7 1 6 6 4 4 8 0 6 9 8 1 5 4 8 3 7 6 4 4 9 1 5 7
3 9 0 0 1 2 1 2 1 7 0 4 1 5 4 7 8 7 2 5 9 1 9 9 8 9 4 3 8 2 5 3 6 4 9 5 0 5 1 4 7 7 1 3 7 9 3 9 9 1 4 7 2 0 5 2 1 9 5 2 9 0 7 9 3 9 6 1 3 7 6 2 1 1 0
7 2 3 8 4 9 4 2 9 0 6 1 6 3 5 7 6 0 4 5 9 6 2 3 1 2 5 3 5 0 6 0 6 8 5 3 7 6 5 1 4 2 3 1 1 5 3 4 9 6 6 5 6 8 3 7 1 5 1 1 6 6 0 4 2 2 0 7 9 6 3 9 4 4 6