4 6 6 2 1 1 6 3 2 5 5 1 5 7 7 2 9 0 7 0 9 7 8 4 7 3 1 5 6 2 7 8 2 7 7 5 9 8 7 8 8 1 3 6 4 9 1 9 5 1 2 5 7 4 8 3 3 2 8 7 9 3 7 7 1 5 7 1 4 5 9 0 9 1 0 6
4 8 4 1 6 4 2 6 7 8 3 0 9 9 4 9 7 2 3 6 7 4 4 2 0 1 7 5 8 6 2 2 6 9 4 0 2 1 5 9 4 0 7 9 2 4 4 8 0 5 4 1 2 5 5 3 6 0 4 3 1 3 1 7 9 9 2 6 9 6 7 3 9 1 5
7 5 4 2 4 1 9 2 9 6 6 0 7 3 1 2 3 9 3 7 6 3 5 4 2 1 3 9 2 3 0 6 1 7 8 7 6 7 5 3 9 5 8 7 1 1 4 3 6 1 0 4 0 8 9 4 0 9 9 6 6 0 8 9 4 7 1 4 1 8 3 4 0 6 9
8 3 6 2 9 9 3 6 7 5 3 6 2 6 2 1 5 4 5 2 4 7 2 9 8 4 6 4 2 1 3 7 5 2 8 9 1 0 7 9 8 8 4 3 8 1 3 0 6 0 9 5 5 5 2 6 2 2 7 2 0 8 3 7 5 1 8 6 2 9 8 3 7 0 6
6 7 8 7 2 2 4 4 3 0 1 9 5 7 9 3 7 9 3 7 8 6 0 7 2 1 0 7 2 5 4 2 7 7 2 8 9 0 7 1 7 3 2 8 5 4 8 7 4 3 7 4 3 5 5 7 8 1 9 6 6 5 1 1 7 1 6 6 1 8 3 3 0 8 8
1 1 2 9 1 2 0 2 4 5 2 0 4 0 4 8 6 8 2 2 0 0 0 7 2 3 4 4 0 3 5 0 2 5 4 4 8 2 0 2 8 3 4 2 5 4 1 8 7 8 8 4 6 5 3 6 0 2 5 9 1 5 0 6 4 4 5 2 7 1 6 5 7 7 0
0 0 4 4 5 2 1 0 9 7 7 3 5 5 8 5 8 9 7 6 2 2 6 5 5 4 8 4 9 4 1 6 2 1 7 1 4 9 8 9 5 3 2 3 8 3 4 2 1 6 0 0 1 1 4 0 6 2 9 5 0 7 1 8 4 9 0 4 2 7 7 8 9 2 5
8 5 5 2 7 4 3 0 3 5 2 2 1 3 9 6 8 3 5 6 7 9 0 1 8 0 7 6 4 0 6 0 4 2 1 3 8 3 0 7 3 0 8 7 7 4 4 6 0 1 7 0 8 4 2 6 8 8 2 7 2 2 6 1 1 7 7 1 8 0 8 4 2 6 6
4 3 3 3 6 5 1 7 8 0 0 0 2 1 7 1 9 0 3 4 4 9 2 3 4 2 6 4 2 6 6 2 9 2 2 6 1 4 5 6 0 0 4 3 3 7 3 8 3 8 6 8 3 3 5 5 5 5 3 4 3 4 5 3 0 0 4 2 6 4 8 1 8 4 7
3 9 8 9 2 1 5 6 2 7 0 8 6 0 9 5 6 5 0 6 2 9 3 4 0 4 0 5 2 6 4 9 4 3 2 4 4 2 6 1 4 4 5 6 6 5 9 2 1 2 9 1 2 2 5 6 4 8 8 9 3 5 6 9 6 5 5 0 0 9 1 5 4 3 0