4 9 6 7 9 1 2 8 7 4 0 6 8 7 0 5 0 4 8 9 5 8 5 8 6 7 1 7 4 7 9 8 5 4 6 6 7 7 5 7 5 7 3 2 0 5 6 8 1 2 8 8 4 5 9 2 0 5 4 1 3 3 4 0 5 3 9 2 2 0 0 0 1 1 3
7 8 6 3 0 0 9 4 5 5 6 0 6 8 8 1 6 6 7 4 0 0 1 6 9 8 4 2 0 5 5 8 0 4 0 3 3 6 3 7 9 5 3 7 6 4 5 2 0 3 0 4 0 2 4 3 2 2 5 6 6 1 3 5 2 7 8 3 6 9 5 1 1 7 7
8 8 3 8 6 3 8 7 4 4 3 9 6 6 2 5 3 2 2 4 9 8 5 0 6 5 4 9 9 5 8 8 6 2 3 4 2 8 1 8 9 9 7 0 7 7 3 3 2 7 6 1 7 1 7 8 3 9 2 8 0 3 4 9 4 6 5 0 1 4 3 4 5 5 8
8 9 7 0 7 1 9 4 2 5 8 6 3 9 8 7 7 2 7 5 4 7 1 0 9 6 2 9 5 3 7 4 1 5 2 1 1 1 5 1 3 6 8 3 5 0 6 2 7 5 2 6 0 2 3 2 6 4 8 4 7 2 8 7 0 3 9 2 0 7 6 4 3 1 0
0 5 9 5 8 4 1 1 6 6 1 2 0 5 4 5 2 9 7 0 3 0 2 3 6 4 7 2 5 4 9 2 9 6 6 6 9 3 8 1 1 5 1 3 7 3 2 2 7 5 3 6 4 5 0 9 8 8 8 9 0 3 1 3 6 0 2 0 5 7 2 4 8 1 7