6 5 8 5 1 1 8 0 6 3 0 3 6 4 4 2 8 1 2 3 1 4 9 6 5 5 0 7 0 4 7 5 1 0 2 5 4 4 6 5 0 1 1 7 2 7 2 1 1 5 5 5 1 9 4 8 6 6 8 5 0 8 0 0 3 6 8 5 3 2 2 8 1 8 3
1 5 2 1 9 6 0 0 3 7 3 5 6 2 5 2 7 9 4 4 9 5 1 5 8 2 8 4 1 8 8 2 9 4 7 8 7 6 1 0 8 5 2 6 3 9 8 1 3 9 5 5 9 9 0 0 6 7 3 7 6 4 8 2 9 2 2 4 4 3 7 5 2 8 7
1 8 4 6 2 4 5 7 8 0 3 6 1 9 2 9 8 1 9 7 1 3 9 9 1 4 7 5 6 4 4 8 8 2 6 2 6 0 3 9 0 3 3 8 1 4 4 1 8 2 3 2 6 2 5 1 5 0 9 7 4 8 2 7 9 8 7 7 7 9 9 6 4 3 7
3 0 8 9 9 7 0 3 8 8 8 6 7 7 8 2 2 7 1 3 8 3 6 0 5 7 7 2 9 7 8 8 2 4 1 2 5 6 1 1 9 0 7 1 7 6 6 3 9 4 6 5 0 7 0 6 3 3 0 4 5 2 7 9 5 4 6 6 1 8 5 5 0 9 6
6 6 6 1 8 5 6 6 4 7 0 9 7 1 1 3 4 4 4 7 4 0 1 6 0 7 0 4 6 2 6 2 1 5 6 8 0 7 1 7 4 8 1 8 7 7 8 4 4 3 7 1 4 3 6 9 8 8 2 1 8 5 5 9 6 7 0 9 5 9 1 0 2 5 9