6 8 6 2 0 0 2 3 5 3 7 1 8 5 8 8 7 4 8 5 6 9 6 5 2 2 0 0 0 5 0 3 1 1 7 3 4 3 9 2 0 7 3 2 1 1 3 9 0 8 0 3 2 9 3 6 3 4 4 7 9 7 2 7 3 5 5 9 5 5 2 7 7 3 4
9 0 7 1 7 8 3 7 9 3 4 2 1 6 3 7 0 1 2 0 5 0 0 5 4 5 1 3 2 6 3 8 3 5 4 4 0 0 0 1 8 6 3 2 3 9 9 1 4 9 0 7 0 5 4 7 9 7 7 8 0 5 6 6 9 7 8 5 3 3 5 8 0 4 8
9 6 6 9 0 6 2 9 5 1 1 9 4 3 2 4 7 3 0 9 9 5 8 7 6 5 5 2 3 6 8 1 2 8 5 9 0 4 1 3 8 3 2 4 1 1 6 0 7 2 2 6 0 2 9 9 8 3 3 0 5 3 5 3 7 0 8 7 6 1 3 8 9 3 9
6 3 9 1 7 7 9 5 7 4 5 4 0 1 6 1 3 7 2 2 3 6 1 8 7 8 9 3 6 5 2 6 0 5 3 8 1 5 5 8 4 1 5 8 7 1 8 6 9 2 5 5 3 8 6 0 6 1 6 4 7 7 9 8 3 4 0 2 5 4 3 5 1 2 8
4 3 9 6 1 2 9 4 6 0 3 5 2 9 1 3 3 2 5 9 4 2 7 9 4 9 0 4 3 3 7 2 9 9 0 8 5 7 3 1 5 8 0 2 9 0 9 5 8 6 3 1 3 8 2 6 8 3 2 9 1 4 7 7 1 1 6 3 9 6 3 3 7 0 9