4 2 4 0 3 1 6 8 9 4 5 8 6 3 6 0 6 0 6 4 5 8 4 5 9 2 5 1 2 6 9 4 6 5 5 7 2 4 8 3 9 1 8 6 5 6 4 2 0 9 7 5 2 6 8 5 0 8 2 3 0 7 5 4 4 2 5 4 5 9 3 7 6
9 1 7 0 4 1 9 7 7 7 8 0 8 5 3 6 2 7 3 0 9 4 1 7 1 0 1 6 3 4 3 4 9 0 7 6 9 6 4 2 3 7 2 2 2 9 4 3 5 2 3 6 6 1 2 5 5 7 2 5 0 8 8 1 4 7 7 9 2 2 3 1 5 1
9 7 4 7 7 8 0 6 0 5 6 9 6 7 2 5 3 8 0 1 7 1 8 0 7 7 6 3 6 0 3 4 6 2 4 5 9 2 7 8 7 7 8 4 6 5 8 5 0 6 5 6 0 5 0 7 8 0 8 4 4 2 1 1 5 2 9 6 9 7 5 2 1 8 9
0 8 7 4 0 1 9 6 6 0 9 0 6 6 5 1 8 0 3 5 1 6 5 0 1 7 9 2 5 0 4 6 1 9 5 0 1 3 6 6 5 8 5 4 3 6 6 3 2 7 1 2 5 4 9 6 3 9 0 8 5 4 9 1 4 4 2 0 1 4 5 7
4 7 6 0 8 1 9 3 0 2 2 1 2 0 6 6 0 2 4 3 3 0 9 6 4 1 2 7 0 4 8 9 4 3 9 0 3 9 7 1 7 7 1 9 5 1 8 0 6 9 0 8 6 9 8 6 0 6 6 3 6 5 8 3 2 3 2 2 7 8 7 0