4 1 6 9 4 8 6 8 5 5 5 8 4 8 4 0 6 3 5 3 4 2 2 0 7 2
2 2 5 8 2 8 4 8 8 6 4 8 1 5 8 4 5 6 0 2 8 5 0 6 0 1
6 8 4 2 7 3 9 4 5 2 2 6 7 4 6 7 6 7 8 8 9 5 2 5 2 1
3 8 5 2 2 5 4 9 5 4 6 6 6 7 2 7 8 2 3 9 8 6 4 5 6 5
9 6 1 1 6 3 5 4 8 8 6 2 3