4 1 5 0 7 6 0 6 9 4 7 9 4 5 1 0 9 6 5 9 6 0 9 4 0 2
5 2 2 8 8 7 9 7 1 0 8 9 3 1 4 5 6 6 9 1 3 6 8 6 7 2
2 8 7 4 8 9 4 0 5 6 0 1 0 1 5 0 3 3 0 8 6 1 7 9 2 8
6 8 0 9 2 0 8 7 4 7 6 0 9 1 7 8 2 4 9 3 8 5 8 9 0 9
7 1 4 9 0 9 6 7 5 9 8 5 2 6 1 3 6 5 5 4 9 7 8 1 8 9