4 8 1 9 1 1 9 7 9 3 9 5 2 0 6 1 4 1 9 6 6 3 4 2 8 7
5 4 4 4 0 6 4 3 7 4 5 1 2 3 7 1 8 1 9 2 1 7 9 8 3 9
1 0 1 5 9 1 9 5 6 1 8 1 4 6 7 5 1 4 2 6 9 1 2 3 9 7
4 8 9 4 0 9 0 7 1 8 6 4 9 4 2 3 1 9 6 1 5 6 7 9 4 5
2 0 8 0 9 5 1 4 6 5 5 0 2 2 5 2 3 1 6 0 3 8 8 1 9 3
0 1 4 2 0 9 3 7 6 2 1 3 7 8 5 5 9 5 6 6 3 8 9 3 7 7