4 8 8 8 8 0 7 8 6 9 2 5 6 0 2 9 0 2 2 8 4 7 2 1 0 4 0 3 1 7 2 1 1 8 6 0 8 2 0 4 1 9 0 4 2 2 9 6 
 6 1 7 1 1 9 6 3 7 7 9 2 1 3 3 7 5 7 5 1 1 4 9 5 9 5 0 1 5 6 6 0 4 9 6 3 1 8 6 2 9 4 7 2 6 5 4 7 3 6 
 4 2 5 2 3 0 8 1 7 7 0 3 6 7 5 1 5 9 0 6 7 3 5 0 2 3 5 0 7 2 8 3 5 4 0 5 6 7 0 4 0 3 8 6 7 4 3 5 1 3 
 6 2 2 2 2 4 7 7 1 5 8 9 1 5 0 4 9 5 3 0 9 8 4 4 4 8 9 3 3 3 0 9 6 3 4 0 8 7 8 0 7 6 9 3 2 5 9 3 9 
 7 8 0 5 4 1 9 3 4 1 4 4 7 3 7 7 4 4 1 8 4 2 6 3 1 2 9 8 6 0 8 0 9 8 8 8 6 8 7 4 1 3 2 6 0 4 7 2 1