 6 6 5 5 7 3 0 9 2 5 4 7 1 1 0 5 5 7 8 5 3 7 6 3 4 6 6 8 2 0 6 5 3 1 0 9 8 9 6 5 2 6 9 1 8 6 2 0 5 6 
 4 7 6 9 3 1 2 5 7 0 5 8 6 3 5 6 6 2 0 1 8 5 5 8 1 0 0 7 2 9 3 6 0 6 5 9 8 7 6 4 8 6 1 1 7 9 1 0 4 5 
 3 3 4 8 8 5 0 3 4 6 1 1 3 6 5 7 6 8 6 7 5 3 2 4 9 4 4 1 6 6 8 0 3 9 6 2 6 5 7 9 7 8 7 7 1 8 5 5 6 0 
 8 4 5 5 2 9 6 5 4 1 2 6 6 5 4 0 8 5 3 0 6 1 4 3 4 4 4 3 1 8 5 8 6 7 6 9 7 5 1 4 5 6 6 1 4 0 6 8 0 0 
 7 0 0 2 3 7 8 7 7 6 5 9 1 3 4 4 0 1 7 1 2 7 4 9 4 7 0 4 2 0 5 6 2 2 3 0 5 3 8 9 9 4 5 6 1 3 1 4 0 7 