5 4 2 8 5 8 4 4 4 7 9 5 2 6 5 8 6 7 8 2 1 0 5 1 1 4
1 3 5 4 7 3 5 7 3 9 5 2 3 1 1 3 4 2 7 1 6 6 1 0 2 1
3 5 9 6 9 5 3 6 2 3 1 4 4 2 9 5 2 4 8 4 9 3 7 1 8 7
1 1 0 1 4 5 7 6 5 4 0 3 5 9 0 2 7 9 3 4 4 0 3 7 4 2
0 7 3 1 0 5 7 8 5 3 9 0 6 2 1 9 8 3 8 7 4 4 7 8 0 8
4 7 8 4 8 9 6 8 3 3 2 1 4