4 0 3 0 6 8 0 3 8 4 4 7 7 3 4 5 4 9 2 0 2 6 0 5 4 1
4 6 6 5 9 2 5 2 0 1 4 9 7 4 4 2 8 5 0 7 3 2 5 1 8 6
6 6 0 2 1 3 2 4 3 4 0 8 8 1 9 0 7 1 0 4 8 6 3 3 1 7
3 4 6 4 9 6 5 1 4 5 3 9 0 5 7 9 6 2 6 8 5 6 1 0 5 5
0 8 1 0 6 6 5 8 7 9 6 9 8 1 6 3 5 7 4 7 3 6 3 8 4 0
5 2 5 7 1 4 5 9 1 0 2 8 9 7 0 6 4 1 4 0 1 1 0 9 7 1
2 0 6 2 8 0 4 3 9 0 3 9 7 5 9 5 1 5 6 7 7 1 5 7 7 0