4 9 3 8 9 7 1 3 1 1 1 7 9 0 4 2 9 7 8 2 8 5 6 4 7 5 0 3 2 0 3 1 9 8 6 9 1 5 1 4 0 2 8 7 0 8 0 8 5 9 
 0 4 8 0 1 0 9 4 1 2 1 4 7 2 2 1 3 1 7 9 4 7 6 4 7 7 7 2 6 2 2 4 1 4 2 5 4 8 5 4 5 4 0 3 3 2 1 5 7 1 
 8 5 3 0 6 1 4 2 2 8 8 1 3 7 5 8 5 0 4 3 0 6 3 3 2 1 7 5 1 8 2 9 7 9 8 6 6 2 2 3 7 1 7 2 1 5 9 1 6 0 
 7 7 1 6 6 9 2 5 4 7 4 8 7 3 8 9 8 6 6 5 4 9 4 9 4 5 0 1 1 4 6 5 4 0 6 2 8 4 3 3 6 6 3 9 3 7 9 0 3 
 9 7 6 9 2 6 5 6 7 2 1 4 6 3 8 5 3 0 6 7 3 6 0 9 6 5 7 1 2 0 9 1 8 0 7 6 3 8 3 2 7 1 6 6 4 1 6 2 7 4