4 1 1 2 7 0 4 0 7 8 5 4 7 3 3 2 6 9 3 9 0 8 1 4 5 4 6 6 4 6 4 5 8 8 0 7 9 7 2 7 0 8 2 6 6 8 3 0 
 6 3 4 3 2 8 5 8 7 8 5 6 9 8 3 0 5 2 3 5 8 0 8 9 3 3 0 6 5 7 5 7 4 0 6 7 9 5 4 5 7 1 6 3 7 7 5 2 5 4 
 2 0 2 1 1 4 9 5 5 7 6 1 5 8 1 4 0 2 5 0 1 2 6 2 2 8 5 9 4 1 3 0 2 1 6 4 7 1 5 5 0 9 7 9 2 5 9 2 3 
 0 9 0 7 9 6 5 4 7 3 7 6 1 2 5 5 1 7 6 5 6 7 5 1 3 5 7 5 1 7 8 2 9 6 6 6 4 5 4 7 7 9 1 7 4 5 0 1 1 
 2 9 6 1 4 8 9 0 3 0 4 6 3 9 4 7 1 3 2 9 6 2 1 0 7 3 4 0 4 3 7 5 1 8 9 5 7 3 5 9 6 1 4 5 8 9 0 1 