4 2 3 0 5 5 8 7 6 3 1 7 6 3 5 9 4 2 1 8 7 3 1 2 5 1
4 7 1 2 0 5 3 2 9 2 8 1 9 1 8 2 6 1 8 6 1 2 5 8 6 7
3 2 1 5 7 9 1 9 8 4 1 4 8 4 8 8 2 9 1 6 4 4 7 0 6 0
9 5 7 5 2 7 0 6 9 5 7 2 2 0 9 1 7 5 6 7 1 1 6 7 2 2
9 1 0 9 8 1 6 9 0 9 1 5 2 8 0 1 7 3 5 0 6 7 1 2 7 4
8 5 8 3 2 2 2 8 7 1 8 3 5 2 0 9 3 5 3 9 6 5 7 2 5 1
2 1 0 8 3 5 7 9 1 5 1 3 6 9 8 8 2 0 9 1 4 4 4 2 1 0
6 7 5 1 0 3 3 4 6 7 1 1 0 3 1 4 1 2