 9 9 0 6 6 5 5 4 1 8 7 6 3 9 7 9 2 9 3 3 4 4 1 9 5 2 1 5 4 1 3 4 1 8 9 9 4 8 5 4 4 4 7 3 4 5 6 7 3 8 
 3 1 6 2 4 9 9 3 4 1 9 1 3 1 8 1 4 8 0 9 2 7 7 7 7 1 0 3 8 6 3 8 7 7 3 4 3 1 7 7 2 0 7 5 4 5 6 5 4 5 
 3 2 2 0 7 7 7 0 9 2 1 2 0 1 9 0 5 1 6 6 0 9 6 2 8 0 4 9 0 9 2 6 3 6 0 1 9 7 5 9 8 8 2 8 1 6 1 3 3 2 
 3 1 6 6 6 3 6 5 2 8 6 1 9 3 2 6 6 8 6 3 3 6 0 6 2 7 3 5 6 7 6 3 0 3 5 4 4 7 7 6 2 8 0 3 5 0 4 5 0 7 
 7 7 2 3 5 5 4 7 1 0 5 8 5 9 5 4 8 7 0 2 7 9 0 8 1 4 3 5 6 2 4 0 1 4 5 1 7 1 8 0 6 2 4 6 4 3 6 2 6 7