 5 6 9 5 1 6 2 3 9 6 5 8 6 4 5 7 3 0 2 1 6 3 1 5 9 8 1 9 3 1 9 5 1 6 7 3 5 3 8 1 2 9 7 4 1 6 7 7 2 9 
 4 7 8 6 7 2 4 2 2 9 2 4 6 5 4 3 6 6 8 0 0 9 8 0 6 7 6 9 2 8 2 3 8 2 8 0 6 8 9 9 6 4 0 0 4 8 2 4 3 5 
 4 0 3 7 0 1 4 1 6 3 1 4 9 6 5 8 9 7 9 4 0 9 2 4 3 2 3 7 8 9 6 9 0 7 0 6 9 7 7 9 4 2 2 3 6 2 5 0 8 2 
 2 1 6 8 8 9 5 7 3 8 3 7 9 8 6 2 3 0 0 1 5 9 3 7 7 6 4 7 1 6 5 1 2 2 8 9 3 5 7 8 6 0 1 5 8 8 1 6 1 7 
 5 5 7 8 2 9 7 3 5 2 3 3 4 4 6 0 4 2 8 1 5 1 2 6 2 7 2 0 3 7 3 4 3 1 4 6 5 3 1 9 7 7 7 7 4 1 6 0 3 1 