4 1 9 2 0 4 1 9 4 7 4 5 5 3 8 5 9 3 8 1 0 2 3 4 3 9 5 5 4 4 9 5 9 7 7 8 3 7 7 9 0 2 3 7 4 2 1 6 1 7 
 2 7 1 1 1 7 2 3 6 4 3 4 3 5 4 3 9 4 7 8 2 2 1 8 1 8 5 2 8 6 2 4 0 8 5 1 4 0 6 6 6 0 4 4 3 3 2 5 8 
 8 8 5 6 9 8 6 7 0 5 4 3 1 5 4 7 0 6 9 6 5 7 4 7 4 5 8 5 5 0 3 3 2 3 2 3 3 4 2 1 0 7 3 0 1 5 4 5 9 4 
 0 5 1 6 5 5 3 7 9 0 6 8 6 6 2 7 3 3 3 7 9 5 8 5 1 1 5 6 2 5 7 8 4 3 2 2 9 8 8 2 7 3 7 2 3 1 9 8 9 
 8 7 5 7 1 4 1 5 9 5 7 8 1 1 1 9 6 3 5 8 3 3 0 5 9 4 0 8 7 3 0 6 8 1 2 1 6 0 2 8 7 6 4 9 6 2 8 6 7