 4 7 8 1 6 4 3 7 8 8 5 1 8 5 2 9 0 9 2 8 5 4 5 2 0 1 1 6 5 8 3 9 3 4 1 9 6 5 6 2 1 3 4 9 1 4 3 4 1 5 
 9 5 6 2 5 8 6 5 8 6 5 5 7 0 5 5 2 6 9 0 4 9 6 5 2 0 9 8 5 8 0 3 3 8 5 0 7 2 2 4 2 6 4 8 2 9 3 9 7 2 
 8 5 8 4 7 8 3 1 6 3 0 5 7 7 7 7 5 6 0 6 8 8 8 7 6 4 4 6 2 4 8 2 4 6 8 5 7 9 2 6 0 3 9 5 3 5 2 7 7 3 
 4 8 0 3 0 4 8 0 2 9 0 5 8 7 6 0 7 5 8 2 5 1 0 4 7 4 7 0 9 1 6 4 3 9 6 1 3 6 2 6 7 6 0 4 4 9 2 5 6 
 2 7 4 2 0 4 2 0 8 3 2 0 8 5 6 6 1 1 9 0 6 2 5 4 5 4 3 3 7 2 1 3 1 5 3 5 9 5 8 4 5 0 6 8 7 7 2 4 6 0 