 2 9 0 1 6 1 8 7 6 6 7 9 5 2 4 0 6 1 6 3 4 2 5 2 2 5 7 7 1 9 5 4 2 9 1 6 2 9 9 1 9 3 0 6 4 5 5 3 7 7 
 9 9 1 4 0 3 7 3 4 0 4 3 2 8 7 5 2 6 2 8 8 8 9 6 3 9 9 5 8 7 9 4 7 5 7 2 9 1 7 4 6 4 2 6 3 5 7 4 5 5 
 2 5 4 0 7 9 0 9 1 4 5 1 3 5 7 1 1 1 3 6 9 4 1 0 9 1 1 9 3 9 3 2 5 1 9 1 0 7 6 0 2 0 8 2 5 2 0 2 6 1 
 8 7 9 8 5 3 1 8 8 7 7 0 5 8 4 2 9 7 2 5 9 1 6 7 7 8 1 3 1 4 9 6 9 9 0 0 9 0 1 9 2 1 1 6 9 7 1 7 3 7 
 2 7 8 4 7 6 8 4 7 2 6 8 6 0 8 4 9 0 0 3 3 7 7 0 2 4 2 4 2 9 1 6 5 1 3 0 0 5 0 0 5 1 6 8 3 2 3 3 6 4