 4 6 1 1 9 9 6 6 5 3 8 5 8 1 5 3 8 4 2 0 5 6 8 5 3 3 8 6 2 1 8 6 7 2 5 2 3 3 4 0 2 8 3 0 8 7 1 1 2 3 
 2 8 2 7 8 9 2 1 2 5 0 7 7 1 2 6 2 9 4 6 3 2 2 9 5 6 3 9 8 9 8 9 8 9 3 5 8 2 1 1 6 7 4 5 6 2 7 0 1 0 
 2 1 8 3 5 6 4 6 2 2 0 1 3 4 9 6 7 1 5 1 8 8 1 9 0 9 7 3 0 3 8 1 1 9 8 0 0 4 9 7 3 4 0 7 2 3 9 6 1 0 
 3 6 8 5 4 0 6 6 4 3 1 9 3 9 5 0 9 7 9 0 1 9 0 6 9 9 6 3 9 5 5 2 4 5 3 0 0 5 4 5 0 5 8 0 6 8 5 5 0 1 
 9 5 6 7 3 0 2 2 9 2 1 9 1 3 9 3 3 9 1 8 5 6 8 0 3 4 4 9 0 3 9 8 2 0 5 9 5 5 1 0 0 2 2 6 3 5 3 5 3 6