 4 4 6 0 4 7 7 4 6 4 9 1 5 9 9 5 0 5 4 9 7 3 7 4 2 5 6 2 6 9 0 1 0 4 9 0 3 7 7 8 1 9 8 6 8 3 5 9 3 8 
 1 4 6 5 7 4 1 2 6 8 0 4 9 2 5 6 4 8 7 9 8 5 5 6 1 4 5 3 7 2 3 4 7 8 6 7 3 3 0 3 9 0 4 6 8 8 3 8 3 4 
 3 6 3 4 6 5 5 3 7 9 4 9 8 6 4 1 9 2 7 0 5 6 3 8 7 2 9 3 1 7 4 8 7 2 3 3 2 0 8 3 7 6 0 1 1 2 3 0 2 9 
 9 1 1 3 6 7 9 3 8 6 2 7 0 8 9 4 3 8 7 9 9 3 6 2 0 1 6 2 9 5 1 5 4 1 3 3 7 1 4 2 4 8 9 2 8 3 0 7 2 2 
 0 1 2 6 9 0 1 4 7 5 4 6 6 8 4 7 6 5 3 5 7 6 1 6 4 7 7 3 7 9 4 6 7 5 2 0 0 4 9 0 7 5 7 1 5 5 5 2 7 8