4 1 9 6 5 3 6 2 1 3 2 3 9 2 6 4 0 6 1 6 0 1 3 6 3 5 8 1 5 5 9 0 7 4 2 2 0 2 0 2 0 3 1 8 7 2 7 7 6 0 5 
 2 7 7 2 1 9 0 5 5 6 1 4 8 4 2 5 5 5 1 8 7 9 2 5 3 0 3 4 3 5 1 3 9 8 4 4 2 5 3 2 2 3 4 1 5 7 6 2 3 
 3 6 1 0 6 4 2 5 0 6 3 9 0 4 9 7 5 0 8 6 5 6 2 7 1 0 9 5 3 5 9 1 9 4 6 5 8 9 7 5 1 4 1 3 1 0 3 4 8 
 2 2 7 6 9 3 0 6 2 4 7 4 3 5 3 6 3 2 5 6 9 1 6 0 7 8 1 5 4 7 8 1 8 1 1 5 2 8 4 3 6 6 7 9 5 7 0 6 1 1 
 0 8 6 1 5 3 3 1 5 0 4 4 5 2 1 2 7 4 7 3 9 2 4 5 4 4 9 4 5 4 2 3 6 8 2 8 8 6 0 6 1 3 4 0 8 4 1 4 8 6