4 9 4 5 6 1 2 7 5 3 1 8 1 3 4 0 7 8 3 3 0 3 3 6 2 5 4 2 3 2 7 8 3 9 4 4 9 7 5 3 8 2 4 3 7 2 0 5 8 3 5 
 3 1 1 4 7 7 1 1 9 2 6 0 6 3 8 1 3 3 4 6 7 7 6 8 7 9 6 9 5 9 7 0 3 0 9 8 3 3 9 1 3 0 7 7 1 0 9 8 7 
 0 4 0 8 5 9 1 3 3 7 4 6 4 1 4 4 2 8 2 2 7 7 2 6 3 4 6 5 9 4 7 0 4 7 4 5 8 7 8 4 7 7 8 7 2 0 1 9 2 7 
 7 1 5 2 8 0 7 3 1 7 6 7 9 0 7 7 0 7 1 5 7 2 1 3 4 4 4 7 3 0 6 0 5 7 0 7 3 3 4 9 2 4 3 6 9 3 1 1 3 
 8 3 5 0 4 9 3 1 6 3 1 2 8 4 0 4 2 5 1 2 1 9 2 5 6 5 1 7 9 8 0 6 9 4 1 1 3 5 2 8 0 1 3 1 4 7 0 1 3 0 