4 3 5 0 3 8 9 5 1 7 0 2 9 8 9 3 9 2 2 3 3 4 5 1 7 2 2 0 1 3 8 1 2 8 0 6 9 6 5 0 1 1 7 8 4 4 0 8 7 4 5 
 1 9 6 0 1 2 1 2 2 8 5 9 3 7 1 6 2 3 1 3 0 1 7 1 1 4 4 4 8 4 6 4 0 9 0 3 8 9 0 6 4 4 9 5 4 4 4 0 
 6 1 9 8 6 9 0 7 5 4 8 5 1 6 0 2 6 3 2 7 5 0 5 2 9 8 3 4 9 1 8 7 4 0 7 8 6 6 8 0 8 8 1 8 3 3 8 5 1 0 
 2 2 8 3 3 4 5 0 8 5 0 4 8 6 0 8 2 5 0 3 9 3 0 2 1 3 3 2 1 9 7 1 5 5 1 8 4 3 0 6 3 5 4 5 5 0 7 6 6 
 8 2 8 2 9 4 9 3 0 4 1 3 7 7 6 5 5 2 7 9 3 9 7 5 1 7 5 4 6 1 3 9 5 3 9 8 4 6 8 3 3 9 3 6 3 8 3 0 4 7