4 3 7 7 6 7 0 9 6 1 2 0 7 1 5 1 2 4 9 1 4 0 4 3 0 2 7 2 5 3 8 6 0 7 6 4 8 2 3 6 3 4 1 4 3 3 4 6 2 3 
 5 1 8 9 7 5 7 6 6 4 5 2 1 6 4 1 3 7 6 7 9 6 9 0 3 1 4 9 5 0 1 9 1 0 8 5 7 5 9 8 4 4 2 3 9 1 9 8 6 2 
 9 1 6 4 2 1 9 3 9 4 9 0 7 2 3 6 2 3 4 6 4 6 8 4 4 1 1 7 3 9 4 0 3 2 6 5 9 1 8 4 0 4 4 3 7 8 0 5 1 
 3 3 3 8 9 4 5 2 5 7 4 2 3 9 5 0 8 2 9 6 5 9 1 2 2 8 5 0 8 5 5 5 8 2 1 5 7 2 5 0 3 1 0 7 1 2 5 7 0 
 1 2 6 6 8 3 0 2 4 0 2 9 2 9 5 2 5 2 2 0 1 1 8 7 2 6 7 6 7 5 6 2 2 0 4 1 5 4 2 0 5 1 6 1 8 4 1 6 3 4