 4 8 4 7 5 6 5 1 6 9 8 1 1 6 1 4 1 0 1 0 2 9 6 0 7 8 3 8 6 9 0 9 2 9 1 6 0 3 0 2 8 8 4 0 2 6 
 9 1 0 4 1 4 0 7 9 2 8 8 6 2 1 5 0 7 8 4 2 4 5 1 6 7 0 9 0 8 7 0 6 9 2 8 2 1 2 0 6 6 0 4 1 8 3 
 7 1 8 0 6 5 3 5 5 6 7 2 5 2 5 3 2 5 6 7 5 3 2 8 6 1 2 9 1 0 4 2 4 8 7 7 6 1 8 2 5 8 2 9 7 6 5 1 5 7 
 9 5 9 8 4 7 0 3 5 6 2 2 2 6 2 9 3 4 8 6 0 3 4 1 5 8 7 2 2 9 8 0 5 3 4 9 8 9 6 5 0 2 2 6 2 9 1 7 4 
 8 7 8 8 2 0 2 7 3 4 2 0 9 2 2 2 2 4 5 3 3 9 8 5 6 2 6 4 7 6 6 9 1 4 9 0 5 5 6 2 8 4 2 5 0 3 9 1 2 7