 5 7 7 1 0 2 8 4 0 2 7 9 9 8 0 6 6 3 6 5 8 2 5 4 8 8 9 2 6 4 8 8 0 2 5 4 5 6 6 1 0 1 7 2 9 6 7 0 2 6 
 6 4 0 7 6 5 5 9 0 4 2 9 0 9 9 4 5 6 8 1 5 0 6 5 2 6 5 3 0 5 3 7 1 8 2 9 4 1 2 7 0 3 3 6 9 3 1 3 7 8 
 5 1 7 8 6 0 9 0 4 0 7 0 8 6 6 7 1 1 4 9 6 5 5 8 3 4 3 4 3 4 7 6 9 3 3 8 5 7 8 1 7 1 1 3 8 6 4 5 5 8 
 7 3 6 7 8 1 2 3 0 1 4 5 8 7 6 8 7 1 2 6 6 0 3 4 8 9 1 3 9 0 9 5 6 2 0 0 9 9 3 9 3 6 1 0 3 1 0 2 9 1 
 6 1 6 1 5 2 8 8 1 3 8 4 3 7 9 0 9 9 0 4 2 3 1 7 4 7 3 3 6 3 9 4 8 0 4 5 7 5 9 3 1 4 9 3 1 4 0 5 2 9